0,0,0,0,0,0,0,0,0,0,0,0,0,0,0,0,0,0,0,0,24,26,0,0,0,0,0,0,0,0,0,0,0,0,0,0,0,0,0,0
0,0,0,0,0,0,0,0,0,0,0,0,0,0,0,0,0,0,0,0,24,26,0,0,0,0,0,0,0,0,0,0,0,0,0,0,0,0,0,0
0,0,0,0,0,0,0,0,0,0,0,0,0,0,0,0,0,0,0,0,24,26,0,0,0,0,0,0,0,0,0,0,0,0,0,0,0,0,0,0
0,0,0,0,0,0,0,0,0,0,0,0,0,0,0,0,0,0,0,0,24,26,0,0,0,0,0,0,0,0,0,0,0,0,0,0,0,0,0,0
0,0,0,0,0,0,0,0,0,0,0,0,0,0,0,0,0,0,0,0,24,26,0,0,0,0,0,0,0,0,0,0,0,0,0,0,0,0,0,0
0,0,0,0,0,0,0,0,0,0,0,0,0,0,0,0,0,0,0,0,24,26,0,0,0,0,0,0,0,0,0,0,0,0,0,0,0,0,0,0
0,0,0,0,0,0,0,0,0,0,0,0,0,0,0,0,0,0,0,0,24,26,0,0,0,0,0,0,0,0,0,0,0,0,0,0,0,0,0,0
0,0,0,0,0,0,0,0,0,0,0,0,0,0,0,0,0,0,0,0,24,26,0,0,0,0,0,0,0,0,0,0,0,0,0,0,0,0,0,0
2,0,0,0,1,0,0,0,2,0,1,0,0,0,0,0,0,1,0,0,24,26,1,2,2,0,0,2,0,0,0,0,0,0,0,0,0,0,0,0
0,0,0,0,0,2,2,2,1,0,0,0,0,0,0,0,0,0,1,0,24,26,0,1,0,0,0,0,0,0,0,1,0,0,0,0,0,0,0,0
0,0,0,0,0,0,0,0,0,0,0,0,0,0,1,0,1,0,0,0,24,26,0,0,1,0,0,1,0,0,0,0,1,0,0,0,0,0,0,0
0,0,0,0,0,2,0,1,0,0,0,0,0,0,0,1,0,0,0,0,24,26,2,0,0,0,2,0,0,0,0,0,0,0,0,0,0,0,0,0
0,0,0,0,0,0,1,0,0,0,2,0,0,0,0,0,0,0,0,0,24,26,0,0,0,0,0,0,0,0,0,0,2,0,0,0,0,0,0,0
0,0,1,0,0,0,2,0,0,2,0,0,1,1,0,0,0,0,1,0,24,26,0,0,0,0,0,0,0,0,0,1,1,0,43,0,0,1,0,2
0,0,0,1,0,0,2,0,0,1,0,2,0,1,1,0,1,0,0,0,24,26,0,0,0,0,0,0,0,0,2,0,43,43,0,1,0,0,0,0
0,1,0,0,0,0,0,0,0,0,1,1,0,0,0,0,0,0,0,2,24,26,43,43,43,43,43,43,43,43,43,43,0,0,1,0,0,0,0,0
0,0,0,2,0,0,0,2,1,0,0,0,0,1,0,0,0,0,0,2,24,26,0,0,0,1,0,0,2,0,0,0,0,0,2,1,0,0,0,2
0,0,2,0,2,0,1,0,0,1,0,0,0,2,0,2,0,2,1,0,24,26,0,0,2,0,0,0,1,1,2,0,0,0,0,0,0,0,1,0
2,2,2,0,0,2,2,0,0,0,0,0,0,0,2,0,0,0,1,1,24,26,0,0,0,0,0,0,1,1,1,0,0,2,0,0,1,0,0,0
0,0,0,0,0,0,0,0,0,0,2,0,0,0,0,0,0,1,0,1,24,26,2,0,0,1,0,0,1,0,2,1,0,2,0,0,1,0,0,0
1,0,2,0,0,0,0,2,0,0,2,0,2,0,0,0,0,0,0,1,24,26,2,2,0,0,2,0,0,0,0,0,0,0,0,0,0,0,0,0
0,2,0,0,0,0,0,0,0,0,0,0,2,0,0,0,1,0,0,0,24,26,1,1,0,0,0,1,0,0,0,0,2,0,1,0,0,0,0,0
2,0,0,0,0,0,0,2,0,0,0,0,0,2,1,0,0,2,0,1,24,26,0,0,2,0,0,0,1,0,0,0,2,0,0,0,1,1,0,2
0,0,0,0,1,0,0,0,0,0,2,0,2,1,0,2,0,0,2,0,24,26,0,0,0,0,0,0,0,1,1,0,0,0,0,0,0,0,0,0
0,0,0,0,0,1,0,0,0,1,0,0,0,0,2,0,2,0,0,0,24,26,0,0,0,0,0,0,2,0,2,0,1,0,0,0,0,2,0,0
0,0,0,0,0,0,0,0,0,0,0,0,0,0,0,0,2,0,2,0,24,26,0,0,0,0,2,0,0,2,0,0,0,0,1,0,2,0,0,0
0,0,0,0,2,1,2,0,0,0,1,1,0,0,0,0,0,1,0,0,24,26,0,0,0,0,0,0,1,0,0,2,1,0,0,0,1,0,0,0
0,0,0,0,0,0,0,0,0,0,1,0,0,0,0,2,2,0,0,0,24,26,0,0,0,0,0,0,0,0,0,0,0,0,1,0,0,0,0,1
0,2,0,0,0,0,0,0,2,1,1,0,0,0,1,0,0,0,0,0,24,26,0,2,0,0,0,0,0,2,0,1,0,0,2,0,0,0,2,0
0,0,0,2,2,0,0,2,2,0,0,0,0,1,1,0,2,1,0,0,24,26,0,1,0,2,0,0,0,2,0,0,0,2,0,0,0,0,2,0
13,13,13,13,13,13,13,13,13,13,13,13,13,13,13,13,13,13,13,13,39,26,0,2,0,0,2,0,0,2,0,0,1,1,0,1,0,2,0,0
37,37,37,37,37,37,37,37,37,37,37,37,37,37,37,37,37,37,37,37,37,38,0,2,0,0,0,0,0,0,2,2,1,0,0,2,0,0,0,0
0,0,2,1,0,0,0,0,0,0,0,0,1,0,0,0,1,0,0,2,2,0,0,0,0,1,0,0,1,1,1,0,1,0,0,0,2,0,0,1
0,0,0,0,0,0,1,0,2,0,0,1,0,0,0,2,0,1,1,2,0,1,0,0,0,0,2,2,0,0,1,0,2,2,0,0,0,0,0,2
0,0,0,0,0,0,0,2,0,1,2,0,0,2,0,0,0,0,0,0,0,0,2,0,2,0,2,0,1,0,0,0,0,0,0,0,0,0,0,0
0,2,2,0,0,0,0,1,0,2,0,0,0,0,0,0,1,1,0,0,0,0,0,0,0,0,0,0,0,0,0,1,1,0,0,0,0,0,0,1
0,0,1,1,1,1,0,0,0,0,1,0,0,0,0,2,0,0,0,0,0,2,0,0,0,0,0,0,0,0,0,0,0,0,0,0,2,0,1,0
2,0,0,1,0,0,0,0,2,0,1,0,1,0,1,1,0,0,0,0,0,1,2,0,0,0,0,1,0,0,0,0,0,0,0,0,0,0,0,0
0,0,0,0,0,2,0,1,0,0,1,0,0,0,0,0,0,0,0,2,0,0,2,0,0,0,0,0,0,0,0,2,0,0,0,0,0,2,0,0
2,0,0,0,0,0,0,0,0,1,2,0,0,2,1,0,0,2,0,1,0,0,0,1,0,2,0,2,0,0,1,1,0,0,0,1,0,0,0,0
